



 1111111
11000011
100N101
1011111
1111 11
