 1111111
11000011
10N0101
1011111
1111 11
