NO img/mosse.xpm
SO img/purplestone.xpm
EA img/greenlight.xpm
WE img/colorstone.xpm
F 125,215,-125
C 255,0,0

1111111
10000W1
1111111