NO img/mosse.xpm
SOimg/purplestone.xpm
EA img/greenlight.xpm
WE img/colorstone.xpm

1111111
10000W1
1111111