NO img/mossy.xpm
SO img/purplestone.xpm
EA img/greenlight.xpm
WE img/colorstone.xpm
F 125,215,125
C 255,0,0

1111111
1000001
1111111